---------------------------------------------------------------------------------------------------
-                           -              -                                                      -
-                           -              -                                                      -
-                           -              -                                                      -
-                           -              -                                                      -
-          ------------------              -                                                      -
-          -                -              ----------------------------------------               -
-          -                -                                                     -----           -
-          -                -                                                     -               -
-          -                -                                                     -               -
-                           -                                                     -               -
-                           -                                                     -               -
-                           -              ---------------                        -               -
-                           -              -             -                        -               -
-                           -              -             -                        -               -
-           -               -              -             -                        -        ----   -
-           -                              -             -           -            -               -
-           -                              -             -           -            -               -
-           -                              -             -           -            -               -
-------------                              -             -           -            -               -
-                                          -             -           -            -               -
-                                          -             -           -            -               -
-                                          -                         -            -               -
-                                          -                         -            -               -
-                                          -                         -            -       -- --   -
-----------------------------              -                         -            -               -   
-                                          -                         -            -               -
-                                          -                         -            -               -
-                                          -                         -            -               -
-                                          -            -            -            -               -
-                                          -            -            -            -         --- ---
-------------------          -     --  -----            -            -                            -
-                            -             -            -            -                            -
-                            -             -            -            -                            -
-                            -             -            -            -                            -
-                            -             -            -            -                            -
-                            -             -            -            -                            -
---------------------------------------------------------------------------------------------------