--------------------------------------------
-                                          -
-                                          -
-                                          -
-                                          -
-                                          -
-                                          -
-                                          -
-                                          -
-                                          -
-                                          -
-                                          -
-                                          -
-                                          -
-                                          -
-                         ---              -
-                                          -
-                                          -
-                                          -
-                                          -
-                                          -
-                                          -
-                                          -
-                                          -
-                                          -
-                                          -
-                                          -
-                                          -
-                                          -
-                                          -
--------------------------------------------